
 ##############################
 #                        #
 #         ################
 #         #
 #         ###########
 ###########         #
       #             #######$
       #             #
       ###############
            #
            #
            #

