
#
#              #####
#              ###
###################
         ##       #
         ##       #
         #        #
         ######                 
######        #
####          #
   # #      ########
   #               ########
   #                      ############
   #                        #########
                             #
                             ###$
