
$### ### #@
 # # # # #
 # ### # # 
 #     # # 
 ### ### # 
   #     #
 # ### ###
 #   # # # 
 ####### #
 
 
