
            ##         #
             #   ########
      ###    #####
        # @     # 
        # #     #
        #########
          #
    #######
    #
    #   #           ####              
    ########        #                 
           #        #                 
           ###########
              #        
              #
           $###