

             
 @    ##########
 #   ##  #      #
 #   ########  #######
 #   #               ##### 
 #   #######         #   #               
 ###### #      ##   ##  ####        
 #    ##########    #    #        
           #        #    #######       
 #         ###########        #
 ###########  #   ##          #
         #        #           #
         #      ###           #
   $#########