                             
    #                  #        
  ##########################
  #                       #
  #                       #
  #                       #
  #                       #
  #########################
  #          $            #
  #          ##############
  #          #       #    #
  #          #       #    #
  #########################
  #     #   ######## # ##
 ###### ## ### ## # # #####
 #         #           #  #
 #         ###         #  #
 #           #         ####
 #########################
 #          #            #
 #          ##############
 #          #       #    #
 #          #       #    #
 #########################
                            
