                                              
  #####  #  #  #    #    #  ####  #### #   #  
    #    #  #  #    #    #  #     #    ## ##  
    #    ####  #    #    #  ####  ####  ###   
    #    #  #  #    #    #  #     #      #    
    #    #  #  #    #    #  #     #      #    
    #    #  #  #### ######  #     #      #    
  ########################################### 
                                              
