                                                              
  #                                                           
  #                                                           
  #                                                           
  #          ########                 #                       
  #          #                        #                       
  #          #                        ########                
  #          #                        #                       
  #####################               #                       
  #                   #               #                       
  #                   #               #                       
  #                   #################                       
  #                   #                                       
  #                   #   ##########                          
  ############        #   #        #                          
          #               #        #                          
          #               #        #                          
          #               #        #                          
          #               ##########                          
     ######                        #                          
     #    #            #############                          
     #    #            #                                      
     #                 #                                      
     #                 #                                      
     #                 #                                      
     #                 #                                      
     #########################################                
     #                                    #                   
     #                                    #                   
     #                                    #                   
     #                                    #                   
     #                                    #                   
     #                                    $                   
                                                              
