                         
 #############       #   
             # ####  #   
     ## ###### #  ####   
 ### #  # #    #  #      
 # ###### # ##### #####  
 #        #       #      
 #######  ##########     
 #   #                   
 ### ################    
   #       #        #    
 ###   ########     ##$  
                         
