                                         
 ### ### #######        
 # # # # # # # #        
 ## ## ## ## ##         
  ###  #$#  ###      
  #           #        
 ##  ## # #   ##         
  #############           
                

