           #          ###########
$#############        #         #
        #    #    #######       #
        ######    #     #       #
     ####    #    #   ###    ####
             #          #    #
      ###################    ###
      #                        #
      #############    #       #
                       #       #
    #############################
          #                #
          #  ###############
          #  #
          $
