########################################
#   #            ######   #            #
###  #     #              #            #
  #  #     #      #################### #
  #  #     #      #    #  #          # #
  #  #     #      #    #  #          # #
  #  #     #      #    #  #          # #
###  ################  #  #        # # #
#                   $###########   # #######
###  ################  #  #    #   #       #
  #  #                 #  #    # # #       #
  #  #                 #  #        #       # 
  #  ###################  #        #       #
  #                       ###      #       # 
  #  ###################  # #      #       #
  #  #                    ###      #       #
  #  #                             #       #
  ########################################## 
