  
  ####
     #   $
     #   #
  ###########
  #      #
  # ###  #
  ###    #####
    #     #  #
  #########  #
             #
