                                
    #                  $       
    #             ###########   
  ########        #       #   
    #   #         #       # #   
    #   #     #####       # #   
    #   #     #   #       # #   
        #         #       # #   
   ################       # #   
        #        ########## #   
        #            #    # #   
        #            #    # #   
        #            #    # #   
        #            #    # #   
        #   #             # #   
        #   #    ##########   
       ######    # #     # ##   
        #   #    #  #    # #    
        ##############    ###   
                               
