                                
     #  $                 #        
     #  #          ###########   
     #  #         #       # #   
     #  #     #####       # #   
     #  #     #   #       # #   
     #  #         #       # #   
  ############    #         #   
        #    ############## #   
        #        ##       # #   
        #        ##       # #   
   $#########$#####       # #   
        #                 # #   
        #                 # #   
        #   #             # #   
        #   #     ######### #   
       ######    # #     # ##   
        #   #    ####    # #    
        ##############   ####   
                               
