                        
 #   ################### 
 #   #                 #                     
 #########             ############         
    #    # ##                             # 
    #########          $        #####     # 
    #     ########             ##   #  #### 
    ##########   #     #### ######  #   ### 
            #          ###  #    #  #    ## 
            #          ##   #    ########## 
            ##################        #$    
            #        ####     #########    
                                               
